111111111111111111111111111111
100000000000000000000000000001
100000000000000000000000000001
100000000000000000000000000001
1000000CCCCCCCCCCC000000000001
100000000000000000000000000001
100000000000000000000000000001
100000000000000000000000000001
100000000000000000000000000001
100000000000GGGGGGGGGGGGG00001
100000000000000000000000000001
100000000000CCCCCCCCCCCCC00001
100000000000000000000000000001
1P00000GGGGGGG000000GGGGG000E1
111111111111111111111111111111
