1111111111
1CCCC1CCC1
1CGGC1CGC1
1CCGC1CGC1
11C1CCCCC1
11C001C0011
1PCC11CCE1
1111111111
