1111111111111111111111111111111111111111
1000000000000000000000000000000000000001
1000000000000000000000000000000000000001
1000000000000000000000000000000000000001
100000CCCCCCCCCCCCCCCCCCCCCCCCC000000001
100000CCCCC0000000CCCCCCCCCCCCC000000001
1000000000000000000000000000000000000001
1000000000000000000000000000000000000001
1000000000000000000000000000000000000001
100000GGGGGGGGGGGGGGG0000000000100000001
100000GGGGGGGGGGGGGGG0000000000100000001
100000GGGGGGGGGGGGGGG0000000000100000001
1000000000000000000000000000000100000001
1000000000000000000000000000000100000001
1000000000000000000000000000000100000001
1000000000000000000000000000000100000001
1000000000000000000000000000000100000001
1000100000000000000000000000000100000001
100010000CC00000000000000000000100000001
100010000CC0G0000000000000G0000100000001
1000100000000000000000000000000100000001
10001GGGG1111111110000100001111100000001
1000000001000001111111110000000100000001
1000000001000000000110000000000100000001
1000000001000000000G00000000000100000001
1000000001000000000000000000000000000001
10000011110000G0000000000000000100000001
10000000000000000000000000000001000000C1
1P000000000000000000000000000000000000E1
1111111111111111111111111111111111111111
