1111111111
1000C1C001
1000111001
1110000001
1100010011
1P001100E1
1111111111