111111111111111111111111111111
1CCC1111111CCCCC00000000000001
1C1CCG00CC10GGG000000000000001
1C11CG01111000GG00000000000001
1CCCC00CCC1CCCCCCC000000000001
100000000CCC000000000000000001
100000000000000000000000000001
100000000000000000000000000001
100000000000000000000000000001
100000000000GGGGGGGGGGGGG00001
100000000000000000000000000001
100000000000CCCCCCCCCCCCC00001
100000000000000000000000000001
1P00000GGGGGGG000000GGGGG000E1
111111111111111111111111111111
