1111111111
1000C1C001
1000G1G001
1110000001
1100010011
1P001100E1
1111111111
